1 1 1 1 1 1 1 1 1 1 1 1 1 1 1
1 5 0 0 0 0 0 5 0 0 0 0 0 5 1
1 0 2 0 2 0 2 0 2 0 2 0 2 0 1
1 0 2 0 2 0 2 0 2 0 2 0 2 0 1
1 0 2 0 2 0 2 0 2 0 2 0 2 0 1
1 0 2 0 2 0 2 1 2 0 2 0 2 0 1
1 0 2 0 2 0 0 0 0 0 2 0 2 0 1 
1 0 0 0 0 0 2 0 2 0 0 0 0 0 1
1 1 0 2 2 0 0 0 0 0 2 2 0 1 1
1 0 0 0 0 0 2 2 2 0 0 0 0 0 1
1 0 2 0 2 0 2 0 2 0 2 0 2 0 1
1 0 2 0 2 0 0 0 0 0 2 0 2 0 1
1 0 2 0 2 0 2 2 2 0 2 0 2 0 1
1 0 0 0 0 4 2 3 2 0 0 0 0 0 1
1 1 1 1 1 1 1 1 1 1 1 1 1 1 1

