111111111111111
150010051000051
102010002020201
102000022021201
100020000010201
160020010026211
166000202006001
102226660006201
100016202020201
112010202000201
102020222021201
102020000000001
102000222020201
102024232022201
111111111111111

