wwwwwwwwwwwwwww
wh     h     hw
w b b b b b b w
w b b b b b b w
w b b bhb b b w
w b b bsb b b w
w b b     b b w
w     b b     w
ws bb     bb sw
w     bbb     w
w b b b b b b w
w b b     b b w
w b b bbb b b w
w    pbeb     w
wwwwwwwwwwwwwww

