1 1 1 1 1 1 1 1 1 1 1 1 1 1 1
1 11 0 0 0 0 0 12 0 0 0 0 0 13 1
1 0 2 0 2 0 2 0 2 0 2 0 2 0 1
1 0 2 0 2 0 2 0 2 0 2 0 2 0 1
1 0 2 0 2 0 2 0 2 0 2 0 2 0 1
1 0 2 0 2 0 2 1 2 0 2 0 2 0 1
1 0 2 0 2 0 0 0 0 0 2 0 2 0 1 
1 0 0 0 0 0 2 0 2 0 0 0 0 0 1
1 1 0 2 2 0 0 0 0 0 2 2 0 1 1
1 0 0 0 0 0 2 2 2 0 0 0 0 0 1
1 0 2 0 2 0 2 0 2 0 2 0 2 0 1
1 0 2 0 2 0 0 0 0 0 2 0 2 0 1
1 0 2 0 2 0 2 2 2 0 2 0 2 0 1
1 0 0 0 0 4 2 3 2 0 0 0 0 0 1
1 1 1 1 1 1 1 1 1 1 1 1 1 1 1

