1 1 1 1 1 1 1 1 1 1 1 1 1 1 1
1 5 0 0 7 0 2 5 0 2 0 2 0 5 1
1 0 0 0 0 0 0 0 0 2 0 1 0 0 1
1 0 0 0 7 0 2 1 0 2 0 2 0 0 1
1 1 0 2 7 0 1 0 2 0 0 2 0 0 1
1 0 0 2 7 0 0 0 2 0 0 0 0 0 1
1 2 0 2 7 7 0 7 7 7 7 0 0 2 1
1 0 0 0 2 0 0 0 6 0 7 0 1 1 1
1 2 2 2 2 0 1 6 6 6 7 0 0 0 1
1 2 0 0 0 0 2 6 6 6 7 0 2 2 1
1 0 0 0 0 0 2 0 6 0 7 0 2 0 1
1 0 1 0 0 0 0 0 0 0 0 0 6 0 1
1 0 2 0 1 0 2 2 2 0 7 6 6 6 1
1 0 0 0 0 4 2 3 2 0 7 6 6 6 1
1 1 1 1 1 1 1 1 1 1 1 1 1 1 1