1 1 1 1 1 1 1 1 1 1 1 1 1 1 1 
1 5 0 0 1 0 0 5 1 0 0 0 0 5 1
1 0 2 0 1 0 0 0 2 0 2 0 2 0 1
1 0 2 0 0 0 0 2 2 0 2 1 2 0 1
1 0 0 0 2 0 0 0 0 0 1 0 2 0 1
1 6 0 0 2 0 0 1 0 0 2 6 2 1 1
1 6 6 0 0 0 2 0 2 0 0 6 0 0 1
1 0 2 2 2 6 6 6 0 0 0 6 2 0 1
1 0 0 0 1 6 2 0 2 0 2 0 2 0 1
1 1 2 0 1 0 2 0 2 0 0 0 2 0 1
1 0 2 0 2 0 2 2 2 0 2 1 2 0 1
1 0 2 0 2 0 0 0 0 0 0 0 0 0 1
1 0 2 0 0 0 2 2 2 0 2 0 2 0 1
1 0 2 0 2 4 2 3 2 0 2 2 2 0 1
1 1 1 1 1 1 1 1 1 1 1 1 1 1 1